*****************
*****************
*******s*********
*****************
*****************
*****************
*****************
***
****
********** *
     **  * *
  *   *  * *
  *****  ***
  *      *
  ***    ******
  *         *
  **************
